NO ./textures/Asset1.xpm
SO ./textures/Asset2.xpm
WE ./textures/Asset4.xpm
EA ./textures/Asset3.xpm

F 220,100,0
C 225,30,0

        111111111 1111111111111111
        1000000001 10110000000000001
        1011000001 1110000000000001
        1001000001 10000000000000001
111111111011000001 1110000000000001
100000000011000001 1110111111111111
11110111111111011 100000010001
11110111111111010 001010010001
11000000110101011 100000010001
10000000000000001 100000010001
10000000000000001 101010010001
11000001110101011 111011110N0111
11110111 1110101 101111010001
11111111 1111111 111111111111