NO ./textures/Asset1.xpm
SO ./textures/Asset2.xpm
WE ./textures/Asset4.xpm
EA ./textures/Asset3.xpm

F 255,255,255
C 0,0,0

111111
100001
100S01
100000
111111