NO ./textures/Asset1.xpm
SO ./textures/Asset2.xpm
WE ./textures/Asset4.xpm
EA ./textures/Asset3.xpm

F 50,50,50
C 100,100,100

11111111111
10000000001
10111111101
10100000101
10101110101
10101W10101
10101110101
10100000101
10111111101
10000000001
11111111111